You wake up in a small, seemingly empty clearing.
2 2 2 2 2 2 2 2 3 3 3 3 2 2 2 2 2 2 2 2 k
2 2 2 2 2 2 2 2 3 3 3 3 2 2 2 2 2 2 2 2 k
2 2 2 2 2 2 2 2 3 3 3 3 2 2 2 2 2 2 2 2 k
2 2 2 2 2 2 2 2 3 3 3 3 2 2 2 2 2 2 2 2 k
2 2 2 2 2 2 2 2 3 3 3 3 2 2 2 2 2 2 2 2 k
2 2 2 2 2 2 2 3 3 3 3 3 3 2 2 2 2 2 2 2 k
2 2 2 2 2 2 3 3 3 3 3 3 3 3 3 2 2 2 2 2 k
2 2 2 2 2 3 3 3 3 3 3 3 3 3 3 3 2 2 2 2 k
2 2 2 2 3 3 3 3 3 3 3 3 3 3 3 3 3 2 2 2 k
2 2 2 3 3 3 3 3 3 3 3 3 3 3 3 3 3 3 2 2 k
2 2 2 3 3 3 3 3 3 3 3 3 3 3 3 3 3 3 2 2 k
2 2 2 3 3 3 3 3 3 3 3 3 3 3 3 3 3 3 2 2 k
2 2 2 3 3 3 3 3 3 3 3 3 3 3 3 3 3 3 2 2 k
2 2 2 3 3 3 3 3 3 3 3 3 3 3 3 3 3 3 2 2 k
2 2 2 3 3 3 3 3 3 3 3 3 3 3 3 3 3 3 2 2 k
2 2 2 2 2 2 2 2 2 2 2 2 2 2 2 2 2 2 2 2 k
2 2 2 2 2 2 2 2 2 2 2 2 2 2 2 2 2 2 2 2 k
2 2 2 2 2 2 2 2 2 2 2 2 2 2 2 2 2 2 2 2 k
2 2 2 2 2 2 2 2 2 2 2 2 2 2 2 2 2 2 2 2 k
2 2 2 2 2 2 2 2 2 2 2 2 2 2 2 2 2 2 2 2 k
j
1 9 1 
1 10 1
1 11 1
1 12 1
end