You wake up in a small, seemingly empty clearing.
2 2 2 2 2 2 2 2 3 3 3 3 2 2 2 2 2 2 2 2 k
2 2 2 2 2 2 2 2 3 3 3 3 2 2 2 2 2 2 2 2 k
2 2 2 2 2 2 2 2 3 3 3 3 2 2 2 2 2 2 2 2 k
2 2 2 2 2 2 2 2 3 3 3 3 2 2 2 2 2 2 2 2 k
2 2 2 2 2 2 2 2 3 3 3 3 2 2 2 2 2 2 2 2 k
2 2 2 2 2 2 2 3 3 3 3 3 3 2 2 2 2 2 2 2 k
2 2 2 2 2 2 3 3 3 3 3 3 3 3 3 2 2 2 2 2 k
2 2 2 2 2 3 3 3 3 3 3 3 3 3 3 3 2 2 2 2 k
2 2 2 2 3 3 3 3 3 3 3 3 3 3 3 3 3 2 2 2 k
2 2 2 3 3 3 3 3 3 3 3 3 3 3 3 3 3 3 2 2 k
2 2 2 3 3 3 3 3 3 3 3 3 3 3 3 3 3 3 2 2 k
2 2 2 3 3 3 3 3 3 3 3 3 3 3 3 3 3 3 2 2 k
2 2 2 3 3 3 3 3 3 3 3 3 3 3 3 3 3 3 2 2 k
2 2 2 3 3 3 3 3 3 3 3 3 3 3 3 3 3 3 2 2 k
2 2 2 3 3 3 3 3 3 3 3 3 3 3 3 3 3 3 2 2 k
2 2 2 2 2 2 2 2 2 2 2 2 2 2 2 2 2 2 2 2 k
2 2 2 2 2 2 2 2 2 2 2 2 2 2 2 2 2 2 2 2 k
2 2 2 2 2 2 2 2 2 2 2 2 2 2 2 2 2 2 2 2 k
2 2 2 2 2 2 2 2 2 2 2 2 2 2 2 2 2 2 2 2 k
2 2 2 2 2 2 2 2 2 2 2 2 2 2 2 2 2 2 2 2 k
j
0 8 1 
0 9 1
0 10 1
0 11 1
end
1 10 1