What is this place...? What happened to you?
2 2 2 2 2 2 2 2 3 3 3 3 2 2 2 2 2 2 2 2 k
2 2 2 2 2 2 2 2 3 3 3 3 2 2 2 2 2 2 2 2 k
2 2 2 2 2 2 2 2 3 3 3 3 2 2 2 2 2 2 2 2 k
2 2 2 2 2 2 2 2 3 3 3 3 2 2 2 2 2 2 2 2 k
2 2 2 2 2 2 2 2 3 3 3 3 2 2 2 2 2 2 2 2 k
2 2 2 2 2 2 2 2 3 3 3 3 2 2 2 2 2 2 2 2 k
2 2 2 2 2 2 2 2 3 3 3 3 3 3 3 3 3 3 3 3 k
2 2 2 2 2 2 2 2 3 3 3 3 3 3 3 3 3 3 3 3 k
2 2 2 2 2 2 2 2 3 3 3 3 3 3 3 3 3 3 3 3 k
2 2 2 2 2 2 2 2 3 3 3 3 3 3 3 3 3 3 3 3 k
2 2 2 2 2 2 2 2 3 3 3 3 3 2 2 2 2 2 2 2 k
2 2 2 2 2 2 2 2 3 3 3 3 2 2 2 2 2 2 2 2 k
2 2 2 2 2 2 2 2 3 3 3 3 2 2 2 2 2 2 2 2 k
2 2 2 2 2 2 2 2 3 3 3 3 2 2 2 2 2 2 2 2 k
2 2 2 2 2 2 2 2 3 3 3 3 2 2 2 2 2 2 2 2 k
2 2 2 2 2 2 2 2 3 3 3 3 2 2 2 2 2 2 2 2 k
2 2 2 2 2 2 2 2 3 3 3 3 2 2 2 2 2 2 2 2 k
2 2 2 2 2 2 2 2 3 3 3 3 2 2 2 2 2 2 2 2 k
2 2 2 2 2 2 2 2 3 3 3 3 2 2 2 2 2 2 2 2 k
2 2 2 2 2 2 2 2 3 3 3 3 2 2 2 2 2 2 2 2 k
j
0 8 2 
0 9 2
0 10 2
0 11 2
6 19 3
7 19 3
8 19 3
9 19 3
19 8 0
19 9 0
19 10 0
19 11 0
end
18 10 0
1 11 2
7 18 3