What is this place...? What happened to you?
2 2 2 2 2 2 2 2 3 3 3 3 2 2 2 2 2 2 2 2 k
2 2 2 2 2 2 2 2 3 3 3 3 2 2 2 2 2 2 2 2 k
2 2 2 2 2 2 2 2 3 3 3 3 2 2 2 2 2 2 2 2 k
2 2 2 2 2 2 2 2 3 3 3 3 2 2 2 2 2 2 2 2 k
2 2 2 2 2 2 2 2 3 3 3 3 2 2 2 2 2 2 2 2 k
2 2 2 2 2 2 2 2 3 3 3 3 2 2 2 2 2 2 2 2 k
2 2 2 2 2 2 2 2 3 3 3 3 3 3 3 3 3 3 3 3 k
2 2 2 2 2 2 2 2 3 3 3 3 3 3 3 3 3 3 3 3 k
2 2 2 2 2 2 2 2 3 3 3 3 3 3 3 3 3 3 3 3 k
2 2 2 2 2 2 2 2 3 3 3 3 3 3 3 3 3 3 3 3 k
2 2 2 2 2 2 2 2 3 3 3 3 3 2 2 2 2 2 2 2 k
2 2 2 2 2 2 2 2 3 3 3 3 2 2 2 2 2 2 2 2 k
2 2 2 2 2 2 2 2 3 3 3 3 2 2 2 2 2 2 2 2 k
2 2 2 2 2 2 2 2 3 3 3 3 2 2 2 2 2 2 2 2 k
2 2 2 2 2 2 2 2 3 3 3 3 2 2 2 2 2 2 2 2 k
2 2 2 2 2 2 2 2 3 3 3 3 2 2 2 2 2 2 2 2 k
2 2 2 2 2 2 2 2 3 3 3 3 2 2 2 2 2 2 2 2 k
2 2 2 2 2 2 2 2 3 3 3 3 2 2 2 2 2 2 2 2 k
2 2 2 2 2 2 2 2 3 3 3 3 2 2 2 2 2 2 2 2 k
2 2 2 2 2 2 2 2 3 3 3 3 2 2 2 2 2 2 2 2 k
j
1 9 2 
1 10 2
1 11 2
1 12 2
7 20 3
8 20 3
9 20 3
10 20 3
end
20 9 0
20 10 0
20 11 0
20 12 0