Man what's the deal with airplane food anyway.
0 0 0 0 0 0 0 0 0 0 0 0 0 0 0 0 0 0 0 0 k
0 1 1 0 1 1 1 1 1 1 1 1 1 1 1 1 0 0 0 0 k
0 1 1 0 1 1 1 1 1 1 1 1 1 1 1 1 0 0 0 0 k
0 1 1 0 1 1 0 0 0 0 1 1 0 0 0 0 0 0 0 0 k
0 1 1 0 1 1 0 1 1 1 1 1 1 1 1 0 1 1 1 0 k
0 1 1 0 1 1 0 1 1 1 1 1 1 1 1 0 1 1 1 0 k
0 1 1 1 1 1 0 1 1 1 1 1 1 1 1 0 1 1 1 0 k
0 1 1 1 1 1 0 1 1 1 1 1 1 1 1 0 1 1 1 0 k
0 1 1 0 1 1 0 1 1 1 1 1 1 1 1 0 1 1 1 0 k
0 1 1 0 1 1 0 1 1 1 1 1 1 1 1 0 1 1 1 0 k
0 1 1 0 1 1 0 1 1 1 1 1 1 1 1 0 1 1 1 0 k
0 1 1 0 1 1 0 1 1 1 1 1 1 1 1 0 1 1 1 0 k
0 1 1 0 1 1 0 0 0 0 0 0 0 0 0 0 1 1 1 0 k
0 1 1 0 1 1 1 1 1 1 1 1 1 1 1 1 1 1 1 0 k
0 1 1 0 1 1 1 1 1 1 1 1 1 1 1 1 1 1 1 0 k
0 1 1 0 1 1 1 1 1 1 1 1 1 1 1 1 1 1 1 0 k
0 1 1 0 0 0 0 0 0 0 0 0 0 0 0 0 0 0 1 0 k
0 1 1 1 1 1 1 1 1 1 0 1 1 1 1 1 1 1 1 0 k
0 1 1 1 1 1 1 1 1 1 0 1 1 1 1 1 1 1 1 0 k
0 0 0 0 0 0 0 0 0 0 0 0 0 0 0 0 0 0 0 0 k