null
0 0 0 0 0 0 0 0 1 1 1 1 0 0 0 0 0 0 0 0 k
0 0 0 0 0 0 0 0 1 1 1 1 0 0 0 0 0 0 0 0 k
0 0 0 0 0 0 0 0 1 1 1 1 0 0 0 0 0 0 0 0 k
0 0 0 0 0 0 0 0 1 1 1 1 0 0 0 0 0 0 0 0 k
0 0 0 0 0 0 0 0 1 1 1 1 0 0 0 0 0 0 0 0 k
0 0 0 0 0 0 0 0 1 1 1 1 0 0 0 0 0 0 0 0 k
1 1 1 1 1 1 1 1 1 1 1 1 0 0 0 0 0 0 0 0 k
1 1 1 1 1 1 1 1 1 1 1 1 0 0 0 0 0 0 0 0 k
1 1 1 1 1 1 1 1 1 1 1 1 0 0 0 0 0 0 0 0 k
1 1 1 1 1 1 1 1 1 1 1 1 0 0 0 0 0 0 0 0 k
0 0 0 0 0 0 0 1 0 0 0 0 0 0 0 0 0 0 0 0 k
0 0 0 0 0 0 0 0 0 0 0 0 0 0 0 0 0 0 0 0 k
0 0 0 0 0 0 0 0 0 0 0 0 0 0 0 0 0 0 0 0 k
0 0 0 0 0 0 0 0 0 0 0 0 0 0 0 0 0 0 0 0 k
0 0 0 0 0 0 0 0 1 1 1 1 0 0 0 0 0 0 0 0 k
0 0 0 0 0 0 0 0 1 1 1 1 0 0 0 0 0 0 0 0 k
0 0 0 0 0 0 0 0 1 1 1 1 0 0 0 0 0 0 0 0 k
0 0 0 0 0 0 0 0 1 1 1 1 0 0 0 0 0 0 0 0 k
0 0 0 0 0 0 0 0 1 1 1 1 0 0 0 0 0 0 0 0 k
0 0 0 0 0 0 0 0 1 1 1 1 0 0 0 0 0 0 0 0 k
j
19 9 1
19 10 1
19 11 1
19 12 1
end
18 9 1
18 10 1
18 11 1
18 12 1