Why is this suddenly a cave? And is this the same room?
0 0 0 0 0 0 0 0 1 1 1 1 0 0 0 0 0 0 0 0 k
0 0 0 0 0 0 0 0 1 1 1 1 0 0 0 0 0 0 0 0 k
0 0 0 0 0 0 0 0 1 1 1 1 0 0 0 0 0 0 0 0 k
0 0 0 0 0 0 0 0 1 1 1 1 0 0 0 0 0 0 0 0 k
0 0 0 0 0 0 0 0 1 1 1 1 0 0 0 0 0 0 0 0 k
0 0 0 0 0 0 0 0 1 1 1 1 0 0 0 0 0 0 0 0 k
1 1 1 1 1 1 1 1 1 1 1 1 0 0 0 0 0 0 0 0 k
1 1 1 1 1 1 1 1 1 1 1 1 0 0 0 0 0 0 0 0 k
1 1 1 1 1 1 1 1 1 1 1 1 0 0 0 0 0 0 0 0 k
1 1 1 1 1 1 1 1 1 1 1 1 0 0 0 0 0 0 0 0 k
0 0 0 0 0 0 0 1 0 0 0 0 0 0 0 0 0 0 0 0 k
0 0 0 0 0 0 0 0 0 0 0 0 0 0 0 0 0 0 0 0 k
0 0 0 0 0 0 0 0 0 0 0 0 0 0 0 0 0 0 0 0 k
0 0 0 0 0 0 0 0 0 0 0 0 0 0 0 0 0 0 0 0 k
0 0 0 0 0 0 0 0 1 1 1 1 0 0 0 0 0 0 0 0 k
0 0 0 0 0 0 0 0 1 1 1 1 0 0 0 0 0 0 0 0 k
0 0 0 0 0 0 0 0 1 1 1 1 0 0 0 0 0 0 0 0 k
0 0 0 0 0 0 0 0 1 1 1 1 0 0 0 0 0 0 0 0 k
0 0 0 0 0 0 0 0 1 1 1 1 0 0 0 0 0 0 0 0 k
0 0 0 0 0 0 0 0 1 1 1 1 0 0 0 0 0 0 0 0 k
j
0 8 4
0 9 4
0 10 4
0 11 4
6 0 1
7 0 1
8 0 1
9 0 1
end
7 1 1
