Reality glitches in front of you for a second.
0 0 0 0 0 0 0 0 5 5 3 5 0 0 0 0 0 0 0 0 k
0 0 0 0 0 0 0 0 5 1 5 5 0 0 0 0 0 0 0 0 k
0 0 0 0 0 0 0 0 5 1 1 5 0 0 0 0 0 0 0 0 k
0 0 0 0 0 0 0 0 1 5 1 1 0 0 0 0 0 0 0 0 k
0 0 0 0 0 0 0 0 1 1 1 1 0 0 0 0 0 0 0 0 k
0 0 0 0 0 0 0 0 1 1 5 1 0 0 0 0 0 0 0 0 k
0 0 0 0 0 0 1 1 1 1 1 1 0 0 0 0 0 0 0 0 k
0 0 0 0 0 0 1 1 1 1 1 1 0 0 0 0 0 0 0 0 k
0 0 0 0 0 0 1 1 0 0 0 0 0 0 0 0 0 0 0 0 k
0 0 0 0 0 0 1 1 0 0 0 0 0 0 0 0 0 2 0 4 k
0 0 0 0 0 0 1 1 0 0 0 0 1 1 1 1 1 1 1 3 k
0 0 0 0 0 0 1 1 0 0 0 0 1 1 1 1 1 1 5 1 k
0 0 0 0 0 0 1 1 0 0 0 0 1 1 1 1 1 1 1 3 k
0 0 0 0 0 0 1 1 1 1 1 1 1 1 0 0 0 0 4 2 k
0 0 0 0 0 0 1 1 1 1 1 1 1 1 0 0 0 0 0 0 k
0 0 0 0 0 0 0 0 1 1 1 1 0 0 0 0 0 0 0 0 k
0 0 0 0 0 0 0 0 1 1 1 1 0 0 0 0 0 0 0 0 k
0 0 0 0 0 0 0 0 1 1 1 1 0 0 0 0 0 0 0 0 k
0 0 0 0 0 0 0 0 1 1 1 1 0 0 0 0 0 0 0 0 k
0 0 0 0 0 0 0 0 1 1 1 1 0 0 0 0 0 0 0 0 k
j
1 9 5
1 10 5
1 11 5
1 12 5
11 19 5
12 19 5
13 19 5
14 19 5
end
19 9 1
19 10 1
19 11 1
19 12 1
j