WH AT@ ?@ <Data LEak?>
0 2 0 0 2 2 0 4 3 1 5 1 0 0 2 4 4 0 0 0 k
4 1 1 1 1 1 1 1 1 1 1 1 1 1 1 1 1 1 1 0 k
4 1 3 0 5 1 1 3 5 1 1 1 0 1 1 5 5 1 1 2 k
0 1 0 1 1 1 1 5 3 0 1 1 0 1 1 0 1 0 1 2 k
2 1 0 3 0 1 1 0 1 4 0 1 4 1 1 0 1 0 1 0 k
2 1 0 1 1 1 1 5 1 1 0 1 0 1 1 0 1 0 1 0 k
4 1 1 5 3 1 1 3 3 1 1 0 5 1 1 1 3 1 1 4 k
3 1 1 1 1 1 1 1 1 3 1 1 1 1 5 1 1 1 1 0 k
0 1 1 1 1 1 3 1 1 1 1 1 1 1 1 1 1 1 1 2 k
0 1 1 5 1 1 1 1 1 3 1 3 4 1 1 1 1 3 1 4 k
0 1 1 1 1 1 1 1 1 1 1 1 1 1 3 1 1 1 1 0 k
0 1 1 1 1 1 1 3 1 1 1 1 1 1 1 1 1 1 1 4 k
0 1 1 1 3 1 5 1 1 1 4 1 4 1 1 1 1 1 1 0 k
4 1 1 1 1 5 5 1 3 1 1 1 1 1 1 1 1 1 1 4 k
2 1 1 1 1 1 5 1 1 4 1 4 1 1 5 1 1 1 1 2 k
2 1 1 3 3 1 1 1 1 1 1 1 1 1 1 1 1 1 1 0 k
2 1 1 1 1 1 5 5 3 5 1 1 1 1 1 1 1 1 1 2 k
4 1 1 1 1 1 1 1 1 1 1 1 1 1 1 1 1 1 1 0 k
0 1 1 1 1 1 1 1 1 1 1 1 1 1 1 1 1 1 1 0 k
0 0 4 4 2 2 0 4 5 5 3 1 0 4 2 4 0 4 0 0 k
j
0 9 6
0 10 6
0 11 6
0 12 6
19 8 4
19 9 4
19 10 4
19 11 4
7 0 4
end
18 10 4
1 10 6