...Something's here.
4 4 4 4 4 4 4 4 4 4 4 4 4 4 4 4 4 4 4 4 k
4 4 4 4 4 4 4 4 4 4 4 4 4 4 4 4 4 4 4 4 k
4 4 4 4 4 4 4 4 4 4 4 4 4 4 4 4 4 4 4 4 k
4 4 4 4 4 4 4 4 4 4 4 4 4 4 4 4 4 4 4 4 k
4 4 4 4 4 4 4 4 4 4 4 4 4 4 4 4 4 4 4 4 k
4 4 4 4 4 4 4 4 4 4 4 4 4 4 4 4 4 4 4 4 k
4 4 4 4 4 4 5 5 5 5 5 5 5 5 5 4 4 4 4 4 k
4 4 4 4 4 5 5 5 5 5 5 5 5 5 5 5 4 4 4 4 k
4 4 4 4 5 5 5 5 5 5 5 5 5 5 5 5 5 4 4 4 k
4 4 4 5 5 5 5 5 5 5 5 5 5 5 5 5 5 5 4 4 k
4 4 4 5 5 5 5 5 5 6 6 5 5 5 5 5 5 5 4 4 k
4 4 4 5 5 5 5 5 5 5 5 5 5 5 5 5 5 5 4 4 k
4 4 4 5 5 5 5 5 5 5 5 5 5 5 5 5 5 5 4 4 k
4 4 4 5 5 5 5 5 5 5 5 5 5 5 5 5 5 5 4 4 k
4 4 4 5 5 5 5 5 5 5 5 5 5 5 5 5 5 5 4 4 k
4 4 4 4 4 4 4 4 5 5 5 5 4 4 4 4 4 4 4 4 k
4 4 4 4 4 4 4 4 5 5 5 5 4 4 4 4 4 4 4 4 k
4 4 4 4 4 4 4 4 5 5 5 5 4 4 4 4 4 4 4 4 k
4 4 4 4 4 4 4 4 5 5 5 5 4 4 4 4 4 4 4 4 k
4 4 4 4 4 4 4 4 5 5 5 5 4 4 4 4 4 4 4 4 k
j
end
20 9 5
20 10 5
20 11 5
20 12 5