...Something's here. (put stuff in the middle)
4 4 4 4 4 4 4 4 4 4 4 4 4 4 4 4 4 4 4 4 k
4 4 4 4 4 4 4 4 4 4 4 4 4 4 4 4 4 4 4 4 k
4 4 4 4 4 4 4 4 4 4 4 4 4 4 4 4 4 4 4 4 k
4 4 4 4 4 4 4 4 4 4 4 4 4 4 4 4 4 4 4 4 k
4 4 4 4 4 4 4 4 4 4 4 4 4 4 4 4 4 4 4 4 k
4 4 4 4 4 4 4 4 4 4 4 4 4 4 4 4 4 4 4 4 k
4 4 4 4 4 4 5 5 5 5 5 5 5 5 5 4 4 4 4 4 k
4 4 4 4 4 5 5 5 5 5 5 5 5 5 5 5 4 4 4 4 k
4 4 4 4 5 5 5 5 5 5 5 5 5 5 5 5 5 4 4 4 k
4 4 4 5 5 5 5 5 5 5 5 5 5 5 5 5 5 5 4 4 k
4 4 4 5 5 5 5 5 5 5 5 5 5 5 5 5 5 5 4 4 k
4 4 4 5 5 5 5 5 5 5 5 5 5 5 5 5 5 5 4 4 k
4 4 4 5 5 5 5 5 5 5 5 5 5 5 5 5 5 5 4 4 k
4 4 4 5 5 5 5 5 5 5 5 5 5 5 5 5 5 5 4 4 k
4 4 4 5 5 5 5 5 5 5 5 5 5 5 5 5 5 5 4 4 k
4 4 4 4 4 4 4 4 5 5 5 5 4 4 4 4 4 4 4 4 k
4 4 4 4 4 4 4 4 5 5 5 5 4 4 4 4 4 4 4 4 k
4 4 4 4 4 4 4 4 5 5 5 5 4 4 4 4 4 4 4 4 k
4 4 4 4 4 4 4 4 5 5 5 5 4 4 4 4 4 4 4 4 k
4 4 4 4 4 4 4 4 5 5 5 5 4 4 4 4 4 4 4 4 k
j
19 8 5
19 9 5
19 10 5
19 11 5
end
18 11 5