...Something's here. (put stuff in the middle)
4 4 4 4 4 4 4 4 4 4 4 4 4 4 4 4 4 4 4 4 k
4 4 4 4 4 4 4 4 4 4 4 4 4 4 4 4 4 4 4 4 k
4 4 4 4 4 4 4 4 4 4 4 4 4 4 4 4 4 4 4 4 k
4 4 4 4 4 4 4 4 4 4 4 4 4 4 4 4 4 4 4 4 k
4 4 4 4 4 4 4 4 4 4 4 4 4 4 4 4 4 4 4 4 k
4 4 4 4 4 4 4 4 4 4 4 4 4 4 4 4 4 4 4 4 k
4 4 4 4 4 4 5 5 5 5 5 5 5 5 5 4 4 4 4 4 k
4 4 4 4 4 5 5 5 5 5 5 5 5 5 5 5 4 4 4 4 k
4 4 4 4 5 5 5 5 5 5 5 5 5 5 5 5 5 4 4 4 k
4 4 4 5 5 5 5 5 5 5 5 5 5 5 5 5 5 5 4 4 k
4 4 4 5 5 5 5 5 5 5 5 5 5 5 5 5 5 5 4 4 k
4 4 4 5 5 5 5 5 5 5 5 5 5 5 5 5 5 5 4 4 k
4 4 4 5 5 5 5 5 5 5 5 5 5 5 5 5 5 5 4 4 k
4 4 4 5 5 5 5 5 5 5 5 5 5 5 5 5 5 5 4 4 k
4 4 4 5 5 5 5 5 5 5 5 5 5 5 5 5 5 5 4 4 k
4 4 4 4 4 4 4 4 5 5 5 5 4 4 4 4 4 4 4 4 k
4 4 4 4 4 4 4 4 5 5 5 5 4 4 4 4 4 4 4 4 k
4 4 4 4 4 4 4 4 5 5 5 5 4 4 4 4 4 4 4 4 k
4 4 4 4 4 4 4 4 5 5 5 5 4 4 4 4 4 4 4 4 k
4 4 4 4 4 4 4 4 5 5 5 5 4 4 4 4 4 4 4 4 k
j
end
19 11 5